#####################################################
#                                                   #
#        ####          #                 ###        #
#                      #                   #        #
#                      #       ###         #        #
#    ####              #         #         #        #
#      #                      ## ##        #        #
#      #                                   #        #
#     #     ####                     ####  #        #
#              #######                     #        #
#                    #                     #        #
#           ######   ###                            #
#                                   ######          #
#              ####                      #          #
#                                        #          #
#                                        #          #
#         ####              ####     ####           #
#            #                                      #
#            #                                      #
#         ####   ####  #                            #
#     #  #            #            #############    #
#       #             #                             #
#####################################################